1111111111111111
1T0000P00010T00E
1011111P10101111
101T00101P100001
1P10101010111101
1010111010D0T101
10100D0000100101
1T10111010100T01
1N10001T00100001
1111111111111111