1111111111111111
100000P00010000E
1011111P10101111
101000101P100001
1P10101010111101
1010111010D00101
10100D0000100101
1010111010100101
1N10001000100001
1111111111111111