1111111111111111
1000N0P00010000E
1011111P10101111
1010001010100001
1010101010111101
1010111010D00101
10100D0000100101
1010111010100101
1010001000100001
1111111111111111