11111111111111111111
10000000000000000001
10111111011111101101
10100001010000101001
10101101010110101001
10101100000110000001
10000000000000111111
11111101111110100001
10000001000000101101
10111101011110101101
10100000010010000001
10101111110011111101
10000000000000000001
11111011111111101111
10000010000000101001
10111110111110101001
10000000100000000001
111111111N1111111111