1111111111111111
10N000P000100001
1011111P10101111
1010001010100001
1010101010111101
1010111010000101
1010000000100101
1010111010100101
1010001000100001
1111111111111111